╔═══════                       
║      ■                       
╠ ╦═╦═╦═╦═╦═╦═╦═╦═╦═╦═╦═╦═╦═╦═╗
╠ ╬ ╬ ╬ ╬ ╬ ╬ ╬ ╬ ╬ ╬ ╬ ╬ ╬ ╬ ╣
╠ ╬ ╬ ╬ ╬ ╬ ╬ ╬ ╬ ╬ ╬ ╬ ╬ ╬ ╬ ╣
║ ║ ║ ║ ║ ║ ║   ║ ║ ║ ║ ║   ║ ║
╠ ╬ ╬ ╬ ╬ ╬ ╬ ╬ ╬ ╬ ╬ ╬ ╬ ╬ ╬ ╣
║   ║ ║ ║ ║ ║   ║ ║ ║ ║   ║   ║
╠ ╬ ╬ ╬ ╬ ╬ ╬ ╬ ╬ ╬ ╬ ╬ ╬ ╬ ╬ ╣
╠ ╬ ╬ ╬ ╬ ╬ ╬ ╬ ╬ ╬ ╬ ╬ ╬ ╬ ╬ ╣
║     ║ ║   ║   ║ ║ ║ ║   ║   ║
║ ║     ║       ║ ║ ║ ║   ║   ║
║ ║   ║   ║       ║   ║   ║   ║
╠ ╬ ╬ ╬ ╬ ╬ ╬ ╬ ╬ ╬ ╬ ╬ ╬ ╬ ╬ ╣
║     ║   ║ ║ ║             ║ ║
║       ║ ║ ║ ║     ║     ║ ║ ║
║         ║ ║ ║   ║ ║   ║   ║ ║
║ ║   ║   ║ ║ ║   ║         ║ ║
║ ║ ║ ║ ║ ║ ║ ║             ║ ║
║   ║   ║   ║   ║   ║       ║ ║
╠ ╬ ╬ ╬ ╬ ╬ ╬ ╬ ╬ ╬ ╬ ╬ ╬ ╬ ╬ ╣
╠ ╬ ╬ ╬ ╬ ╬ ╬ ╬ ╬ ╬ ╬ ╬ ╬ ╬ ╬ ╣
╠ ╬ ╬ ╬ ╬ ╬ ╬ ╬ ╬ ╬ ╬ ╬ ╬ ╬ ╬ ╣
║ ║ ║ ║ ║ ║ ║ ║   ║ ║       ║ ║
╠ ╬ ╬ ╬ ╬ ╬ ╬ ╬ ╬ ╬ ╬ ╬ ╬ ╬ ╬ ╣
╠ ╬ ╬ ╬ ╬ ╬ ╬ ╬ ╬ ╬ ╬ ╬ ╬ ╬ ╬ ╣
╚═╩═╩═╩═╩═╩═╩═╩═╩═╩═╩═╩═╩═╩═╩ ╣
                              ║
                       ═══════╝