╔═══════                       
║#######                       
╠#╦═╦═╦═╦═╦═╦═╦═╦═╦═╦═╦═╦═╦═╦═╗
╠#╬ ╬ ╬ ╬ ╬ ╬ ╬ ╬ ╬ ╬ ╬ ╬ ╬ ╬ ╣
╠#╬ ╬ ╬ ╬ ╬ ╬ ╬ ╬ ╬ ╬ ╬ ╬ ╬ ╬ ╣
║#║ ║ ║ ║ ║ ║   ║ ║ ║ ║ ║   ║ ║
╠#╬ ╬ ╬ ╬ ╬ ╬ ╬ ╬ ╬ ╬ ╬ ╬ ╬ ╬ ╣
║#  ║ ║ ║ ║ ║   ║ ║ ║ ║   ║   ║
╠#╬ ╬ ╬ ╬ ╬ ╬ ╬ ╬ ╬ ╬ ╬ ╬ ╬ ╬ ╣
╠#╬ ╬ ╬ ╬ ╬ ╬ ╬ ╬ ╬ ╬ ╬ ╬ ╬ ╬ ╣
║#####║ ║   ║   ║ ║ ║ ║   ║   ║
║ ║  ###║#######║ ║ ║ ║   ║   ║
║ ║   ║###║    ###║   ║   ║###║
╠ ╬ ╬ ╬ ╬ ╬ ╬ ╬ ╬#╬ ╬ ╬ ╬ ╬#╬#╣
║     ║   ║ ║ ║  ###########║#║
║       ║ ║ ║ ║     ║     ║ ║#║
║         ║ ║ ║   ║ ║   ║   ║#║
║ ║   ║   ║ ║ ║   ║         ║#║
║ ║ ║ ║ ║ ║ ║ ║             ║#║
║   ║   ║   ║   ║   ║       ║#║
╠ ╬ ╬ ╬ ╬ ╬ ╬ ╬ ╬ ╬ ╬ ╬ ╬ ╬ ╬#╣
╠ ╬ ╬ ╬ ╬ ╬ ╬ ╬ ╬ ╬ ╬ ╬ ╬ ╬ ╬#╣
╠ ╬ ╬ ╬ ╬ ╬ ╬ ╬ ╬ ╬ ╬ ╬ ╬ ╬ ╬#╣
║ ║ ║ ║ ║ ║ ║ ║   ║ ║       ║#║
╠ ╬ ╬ ╬ ╬ ╬ ╬ ╬ ╬ ╬ ╬ ╬ ╬ ╬ ╬#╣
╠ ╬ ╬ ╬ ╬ ╬ ╬ ╬ ╬ ╬ ╬ ╬ ╬ ╬ ╬#╣
╚═╩═╩═╩═╩═╩═╩═╩═╩═╩═╩═╩═╩═╩═╩#╣
                       #######║
                       ═══════╝