╔═══════                       
║#######                       
╠#╦═╦═╦═╦═╦═╦═╦═╦═╦═╦═╦═╦═╦═╦═╗
║#║   ║   ║       ║   ║   ║   ║
╠#╬ ╬ ╬ ╬ ╬ ╬ ╬ ╬ ╬ ╬ ╬ ╬ ╬ ╬ ╣
║#║ ║ ║ ║ ║ ║   ║ ║ ║ ║ ║   ║ ║
╠#╬ ╬ ╬ ╬ ╬ ╬ ╬ ╬ ╬ ╬ ╬ ╬ ╬ ╬ ╣
║#  ║ ║ ║ ║ ║   ║ ║ ║ ║   ║   ║
╠#╬ ╬ ╬ ╬ ╬ ╬ ╬ ╬ ╬ ╬ ╬ ╬ ╬ ╬ ╣
║###  ║ ║   ║   ║ ║ ║ ║   ║   ║
╠ ╬#╬ ╬ ╬ ╬ ╬ ╬ ╬ ╬ ╬ ╬ ╬ ╬ ╬ ╣
║ ║#####║#######║ ║ ║ ║   ║###║
╠ ╬ ╬ ╬#╬#╬ ╬ ╬#╬ ╬ ╬ ╬ ╬ ╬#╬#╣
║     ║###║ ║ ║#############║#║
╠ ╬ ╬ ╬ ╬ ╬ ╬ ╬ ╬ ╬ ╬ ╬ ╬ ╬ ╬#╣
║       ║ ║ ║ ║     ║     ║ ║#║
╠ ╬ ╬ ╬ ╬ ╬ ╬ ╬ ╬ ╬ ╬ ╬ ╬ ╬ ╬#╣
║         ║ ║ ║   ║ ║   ║   ║#║
╠ ╬ ╬ ╬ ╬ ╬ ╬ ╬ ╬ ╬ ╬ ╬ ╬ ╬ ╬#╣
║ ║   ║   ║ ║ ║   ║         ║#║
╠ ╬ ╬ ╬ ╬ ╬ ╬ ╬ ╬ ╬ ╬ ╬ ╬ ╬ ╬#╣
║ ║ ║ ║ ║ ║ ║ ║             ║#║
╠ ╬ ╬ ╬ ╬ ╬ ╬ ╬ ╬ ╬ ╬ ╬ ╬ ╬ ╬#╣
║ ║ ║ ║ ║ ║ ║ ║   ║ ║       ║#║
╠ ╬ ╬ ╬ ╬ ╬ ╬ ╬ ╬ ╬ ╬ ╬ ╬ ╬ ╬#╣
║   ║   ║   ║   ║   ║       ║#║
╚═╩═╩═╩═╩═╩═╩═╩═╩═╩═╩═╩═╩═╩═╩#╣
                       #######║
                       ═══════╝